#########################################
#A  #   #   #         #         # #     #
### # # # # # # ####### # ##### # # # ###
# #   # # #   #         # #   # #   #   #
# ##### # ############# # # ### # ##### #
#   #   #   #     #   # # #   # # #   # #
# ### ##### ### # # # # # ### # # # ### #
# #   #   #   # # # # # #   # # #   #   #
# # ### ##### ### # # ##### # # ### # # #
#   # #   #   #   # #     # # # #   # # #
# ### # # # ### # # ##### # # # # ### ###
# #   # #   #   # # #   #   # # #   #   #
# ### # ##### ##### # # ##### # ##### # #
#   # #       #     # # #     #     # # #
### # ### ##### ##### ### ### ##### ### #
#   # #   #     #         # #     #   # #
# ### # ### ##### ######### ### # ### # #
#   #     # #     #         #   # #   # #
### # ##### # ####### ##### # ### # ### #
# # # #     # #       # #   #   # #   # #
# # ### ##### # # ##### # ##### # ### # #
#   #   #     # # # #     #   # # #   # #
# ### ### ####### # # ##### # # ### ### #
# #   #   #       #   # #   # # #   #   #
# ### # ### # ##### ### # ### # # ### # #
#     # # # #   # #     # #     #     # #
####### # # ### # ##### # ############# #
#     # #     # # #     #             # #
# # # # ####### # # ########### ####### #
# # # #       # #     #       #     #   #
### # ####### # ##### # ### # ##### # ###
#   #   #     #     # #   # #   # #   # #
# # ##### ##### ### # # ### ### # ##### #
# # #   # # #   #   # # #   #   #       #
# ### # # # # ### ### # # ### ### ##### #
# #   #   #   #   #   # # # # #   #   # #
# # ########### ### ### # # # # ### ### #
# # #         # # # #   # #   # # #     #
# # ##### ### # # # ##### # ### # # #####
#         #     #         #     #      B#
#########################################