#########################################
#A  #       #   #               #       #
### # ##### # # ### ### ####### ### ### #
# #   #   #   #   #   #     # # #   #   #
# ##### # ####### ######### # # # ### ###
#       # #     # #         # #   # #   #
### ##### # # ### # ######### ##### ### #
#   # #   # #   #   #     #   #       # #
# ### # ##### # ####### ### # # # ##### #
# #   #     # #       #     # # #   #   #
# # # ##### # ### ### # ##### # ### # ###
# # #     # # #   #   # #   # # # #   # #
# ##### ### # # ### ##### # # # # ##### #
# #   #   # # #   #       #   #   #     #
# # # # # # ##### ############### # ### #
#   # # #   #     #             #   #   #
##### ### ### ##### ########### ##### ###
#   #   #   #     # #   #     #     #   #
# # ### ### ##### # # ### ### # ### ### #
# #   # #   #     #   #   #     #     # #
# ### # # ### ### ### # # ####### ##### #
#   #   #   #   # #   # # #   #     #   #
### ####### # # ### ### ### # # ##### ###
#   #     # # # #   # #     # # #   #   #
# ### ##### # # # ### ####### ### # ### #
#   #       # # # #     #   #     # #   #
# # # ######### # ### # ### ####### # ###
# # # #         #     #   #     #   # # #
# # # ### ##### ######### # # ### # # # #
# # #     #       #     #   # #   # #   #
### # ########### ##### ##### # ### ### #
#   # #   #   # # #   #     # #   #   # #
# ##### # # # # # # # ### ### ### ### # #
#   #   #   # #     #     #   # #   # # #
# # # ####### # ##### ##### ### ### ### #
# #   #     # # #   # #     #   # #     #
# ####### ### ### # ### ##### # # #######
# #     #   #   # # #   #     # #   #   #
# # ### ### ### # # # ### ##### # # # # #
#   #         #   #       #       #   #B#
#########################################