#########################################
# #S      #     #       #   #     #     #
# ##### # # # ### # # ### # # ### # ### #
#     # #   #     # # #   # # # #   #   #
##### ##### ####### ### ### # # ##### # #
#   #     #       #   # # #   #   #   # #
# # ##### ### ####### # # ##### ### ### #
# #     # #   #     # #         #   # # #
# ### # # ##### ### # ######### # ### # #
# # # # #       #   #           #   #   #
# # # ########### ##### ########### #####
#   #           #     #         #   #   #
### ### ####### ##### # ####### # ### # #
#E    # #     # #   # # #   #   #     # #
####### # ### # # # # ### # # ######### #
#       #   #   # # #     # #         # #
# ##### ######### # ####### ### ####### #
# #     #         #       # #   #       #
# ##### # ############### # ##### ##### #
#     # # #       #   #   #       #     #
# ### # # ### # ### # # ########### #####
# #   # #   # # #   # #     #       #   #
### ####### # ### ### ##### # ####### # #
#   #   #   #     #   #     #       # # #
# ### # # ### ##### ### # ######### ### #
#     # # #       # #   # #       #   # #
# ##### # ######### # ### # ##### ### # #
# # #   # #   #     # #   #   # #   # # #
# # # ### # # # ### # ### ### # ### # # #
# # #   #   #   #   #   # #       # # # #
# # ### ######### ##### # # ####### # # #
#   #       #   #   #   # #   #     #   #
##### ##### # # ### # # ##### # ####### #
#     #   # # #     # # #   # #       # #
# ##### # # # ####### ### # # ##### ### #
# #   # # # #       # #   # # #   #   # #
# # # # # ####### ### # ### # # # ### # #
#   # # #   #     #   # #   #   #   # # #
# ### # ### # ##### ### # ######### # # #
#   #     #       #     #           #   #
#########################################