#########################################
#   #   #           S #             #   #
### # # # # ######### # ##### ##### ### #
# # # #   # #     #   # #   # #   #   # #
# # # ##### # ##### ##### # # # # ### # #
# # # #     # #     #     # # # # #   # #
# # ### ##### # ##### ##### # # ### ### #
# #     #   #   #     #   #   #     #   #
# ####### # # ### ##### ####### ####### #
#       # #   #       #       #         #
# ### ### ##### ##### ### ### ######### #
#   # #   #   # #   #   # #   #         #
# # # # ##### # # # ### # ### # #########
# # # #     # # # # #   #   # # #     # #
# # ####### # # ### # ### # ### # ### # #
# #         # #     # # # #   #   # #   #
# ########### ##### # # # ### ##### ### #
# #   #         #   # #   # # #     #   #
# # ### ####### # ### # ### # # ### # ###
# # #   # #   #   #   # #   #   #   # # #
# # # ### # # ##### ### # # ##### ### # #
# # #   #   #   # # #     #     #     # #
# # ### ##### # # # ########### ####### #
# #           #   #   #   #   #         #
# ################### # # # # ######### #
#                     # # # #   #   # # #
####################### ### # # # # # # #
# #         #               # #   #   # #
# # # ####### ######### ##### ######### #
#   #     #     #     #     #     #     #
####### # # ##### ### ####### ### # #####
#     # # # # #   # #   #   # #   # #   #
# ### ### # # # ### ### # # ### # # # # #
#   # #   #   # # #       #     # #   # #
### # # # ### # # # ############# ##### #
#   #   #   # # #   # #       #   # #   #
# # ##### ### # ### # # ##### # ### # ###
# # #   # #   #   #   #   # # #     #   #
# ### # ### ##### ####### # # ######### #
#     #         #   E       #           #
#########################################